#domain
hospital
#levelname
SACrunch1
#colors
blue: 0, A
#initial
++++++++
+0+    +
+ A+   +
+ + +  +
+    + +
+ ++++ +
+      +
++++++++
#goal
++++++++
+ +   A+
+  +   +
+ + +  +
+    + +
+ ++++ +
+      +
++++++++
#end
